000111100001111111000000110000110000001111111000011110000
000111100001111111000000110000110000001111111000011110000
100000000001111111000000110000110000001111111000000000001
100000000001110000000000000000000000000000111000000000001
111100111000000000000000000000000000000000000001110011111
111100111000000011111100111111110011111100000001110011111
000000111111110011111100111111110011111100111111110000000
000000111111110011111100000000000011111100111111110000000
111100000011110011111100000000000011111100111100000011111
111100000000000000000000110000110000000000000000000011111
111100110000000000000000100000010000000000000000110011111
111100110011110011001100100000010011001100111100110011111
000000110011110011001100100000010011001100111100110000000
000000110011110011001100111111110011001100111100110000000
111100110011110011001100000000000011001100111100110011111
111100110011110011001100000000000011001100111100110011111
111100000000000000000000111001110000000000000000000011111
111100000000000000000000111001110000000000000000000011111
000000111111001111111100000000000011111111001111110000000
000000111111001111111100000000000011111111001111110000000
001100000000000000000000011111100000000000000000000011000
001100000000000000000000011111100000000000000000000011000