10001111100011111000111111111111111100011111000111110001
10001000000010000000111111111111111100000001000000010001
10001000000010000000111111111111111100000001000000010001
10001000000010000000111111111111111100000001000000010001
10001000111110001000000000000000000000010001111100010001
10001000100000001000000000000000000000010000000100010001
10000000100000001000000000000000000000010000000100000001
10000000100000001000100011000011000100010000000100000001
10000000100011111000100000000000000100011111000100000001
10001111100000000000100000000000000100000000000111110001
00000000000000000000100000000000000100000000000000000000
00000000000000000000100011000011000100000000000000000000
00000000000010001111100010000001000111110001000000000000
11111111100010001000000010000001000000010001000111111111
10001000100010001000000010000001000000010001000100010001
10001000100010001000000011111111000000010001000100010001
10001000100010001000100000000000000100010001000100010001
10001000100010001000100000000000000100010001000100010001
10001000100000000000100000000000000100000000000100010001
10001000100000000000100011000011000100000000000100010001
00000000000000000000100000000000000100000000000000000000
00000000000011111000000000000000000000011111000000000000
00000000000000000000000000000000000000000000000000000000